002202220222200
012101212121210
222220222222202
012121210121012
200200000020220
212101010121010
220222002002222
012121212101010
200222200222222
012101212121210
000000022222200